type octile
height 64
width 16
map

@@@@@@@@@@@@@@@@@@@@@@@@@@@@@@@@@@@@@@@@@@@@@@@@@@@@@@@@@@@@@@@@
@........@...@..........@..........@...........................@
@........@..............@..........@...........................@
@@@@@@...@..............@..........@@@@@@@@@@@..@@@@@@@@@......@
@........@...@..........@..........@.........@..@..............@
@.@@..@@@@...@..........@..........@.........@..@..............@
@............@..........@..........@............@..............@
@@@@@@@@@@@@@@@@@@@.....@......@@@@@@@@@@@@@@@@@@@@@@@@@..@@@..@
@.................@.....@..............................@.......@
@.................@.....@..............................@.......@
@.......................@.............@@@@@@@@@@@@@@@..@.......@
@.......................@...................@..........@.......@
@........@@@@@@@@@@@@@@@@...................@..........@.......@
@...........................................@.....@............@
@...........................................@.....@............@
@@@@@@@@@@@@@@@@@@@@@@@@@@@@@@@@@@@@@@@@@@@@@@@@@@@@@@@@@@@@@@@@